daftar istilah dalam kamus psikologi 

A
abnormal -  abnormal
absenteisme - absenteeism  
abstraksi - abstraction
Asia - aphasia 
afeksi - affection
afiliasi - affiliation
afonia - aphonia 
afrasia - aphrasia 
agrafia;  buta tulis - agraphia
 agresi- aggression 
 akrofobia- acrophobia 
 aktivitas - activity 
 aktivitas belajar - learning activity 
 aktivitas kedua tangan - ambidexterity
aktualisasi diri; pengutaraan diri - selfactualization  
alat bantu pengajar - teaching aid
altschmerz
adronitis
alienasi - alienation
aloanamnesis - alloanamnesis
ambang perbedaan - differential threshold
ambang kepekaan -  just noticeable difference 
ambang - spasial spatial threshold 
ambivalensi - ambivalence 
ambiversi - ambiversion 
amnesia masa silam - retrogade amnesia 
anak ajaib wonder - boy 
anak muda - juvenile 
anak prasekolah - preschool child 
anak sukar - problem child 
anak tolakan - rejected child 
analisis awam - lay analysis 
analisis buta - blind analysis 
analisis faktor - factor analysis 
analisis jabatan - job analysis 
analisis mimpi - dream analysis 
anamnesis - anamnesis 
angan-angan - wishful thinking 
anoreksia nervosa - anorexia nervosa 
antagonisme sosial - social antagonism 
antipati - antipathy 
antisipasi - anticipation 
apatis - apathy 
asas kenikmatan - pleasure principle
asas realitas - reality principle 
asosiasi - association 
asosiasionisme - associationism 
asosiasi bebas - free association 
asosiasi stimulus respons - stimulus response association
atavisme - atavism  
aturan pranata - institutional ways 
audiogram - audiogram 
aura - aura 
autosugesti; sugesti diri - autosuggestion 
automatisasi - automatization 
autisme 
anamnesis diri - autoanamnesis

B
bakat - talent 
banci; wadam - transvestite 
baterai tes; rentetan tes - test batteries 
bayangan yang mengejar - imperative idea 
bayangan ketubuhan; gambaran ketubuhan bodi image 
bawaan - inborn 
behaviorisme - behaviorism 
belajar - learning 
belajar bagian - part learning 
belajar insidental - incidental learning 
belajar instrumental - instrumental learning 
belajar keseluruhan - whole learning 
belajar laten - latent learning 
belajar membentuk ide - ide ideational learning 
belajar untuk membeda-bedakan; belajar diskriminatif - discriminative learning 
belum matang - premature 
belajar mental - mental learning 
belajar operan - operant learning 
belajar verbal - verbal learning 
belajar produktif - productive learning 
belajar dengan wawasan - learning by insight 
beralih perhatian - distractibility 
berbakat - gifted 
berbicara dalam hati - internal speech 
berhasil;  sukses - success 
berpikir - thinking 
berpikir animistis - animistic reasoning 
berpikir autistik - autistic thinking 
hambatan sosial - social decrement 
bias - bias 
bimbingan - guidance 
bimbingan kejujuran - vocational guidance 
bodoh - dull 
bulimia; kelaparan - bulimia 
bunuh diri - suicide 

C
cadel - slurring 
cenderung celaka - accident proneness 
cikal bekal - genesis 
cita-cita; derajat aspirasi - level of aspiration 
clairvoyance - clairvoyance 
cuci otak - brainwashing 
coba dan salah - trial and error 

D
deduksi - deduction 
defisiensi mental - mental deficiency 
delinkuen - delinquent 
delinkuen lemah pikiran - defective delinquent 
delusi - delusion 
delusi kebesaran - grandiose delusions 
depersonalisasi - depersonalization 
depresi - depression 
depresi neurotik - neurotic depression 
deprivasi kasih ibu - maternal deprivation 
deprivasi - sosial deprivation 
deskripsi jabatan - job description 
determinisme psikis - psychis determinism 
di atas rata-rata - above average 
diagnosis pembedaan - differential diagnosis 
didaktik - didactics
dinamika kelompok - group dynamics 
disartria - dysarthris 
disfasia - dysphasia 
disfonia - dysphonia 
disgrafia - dysgraphia 
diskrepansi - discrepancy 
diskriminasi - discrimination 
dislalia - dyslalia 
disleksia - dyslexia 
dislogia - dyslogia 
disposisi - disposition 
disposisi emosional - emosional disposition 
disritmia - dysrhytmia 
disosiasi - dissociation 
distimbria - dystimbria 
diri pribadi - self 
doktrin energi khusus - specific energies doctrine 
dominan - dominance 
dorongan - motive 
dorongan manipulasi - manipulative drive 
dorongan mengulang - repetition compulsion 
dorongan sosial - social increment 
dorongan tak terkendali - impulsion 
dril - drill 
dropout - dropout 
dungu; akatalepsi - acatalepsia 

E
efek jenuh - satiation effect 
efek halo - hallo effect 
efek kemurahan hati - leiniency effect 
efek pemanasan - warm up effect 
ego - ego 
egoisme - egoism 
egosentris - egocentric 
eklektisisme - eclecticism 
eksaltasi - exaltation 
ekshibisionisme - exhibitionism 
eksperimen - experiment 
ekspresiriti expressireness; - expressirity 
ekstraversi - extraversion 
ekstrover - extrovert 
embrio - embryo 
emosi - emotion 
empati - empathy 
empirisme - empiricism 
enkopresis - encopresis 
akulturasi - acculturation 
eutanasia - euthanasia 
epilepsi idiopatik - idiopathic epilepsy 
epistemologi - epistemology 
erotik - erotic  
erotisme diri - auto eroticism 
eskapisme - escapism 
etnik - ethnic 
evolusi - evolution 
exulansis

F
faktor-kelompok - group factor 
faktor lingkungan - nurture Faktor 
faktor pencetus - precipitating factor 
faktor umum - general factor 
fanatisme - fanaticism 
fasilitas - facilitation 
figur ayah - father figure 
fiksasi ayah - father fixation 
filogenisasi - phylogenesis 
fenomenologi - phenomenology 
fasilitas sosial - social facilitation 
fetisisme - fetishism 
fiksasi - fixation 
flegmatik - flegmatic 
fobia - phobia 
fobia darah - haemophobia 
frenologi - phrenology 
frustasi - frustration 
fungsi mental - mental function 
furor - furor 
fusi - fusion 

G
gabungan naluri - instinctual fusion 
gagap - stuttering 
gambaran - imago 
gambaran diri pribadi - self image 
gangguan bicara - speech disorder 
gambaran eidetik - eiditic imagery
gangguan karakter - character disorder 
gangguan kemurungan; gangguan depresif - depressive disorder 
gangguan latah - echopathy 
gangguan pelaksanaan; apraksia - apraxia 
gangguan psikogen - psychogenic disorder 
gangguan psikosomatik - psychosomatic disorder 
garis batas - borderline 
garis datar - plateau 
gaya hidup - style of life 
gejala; simtom - symptom 
gejala-gejala Ganser - Ganser syndrome 
gejala Korsakow - Karsakow syndrome 
generasi - generation 
generalisasi - generalization 
geng atau kelompok remaja - youth group
genius - genius 
gerombolan - gang 

H
halusinasi - hallucination 
halusinosis - hallucinosis 
hambatan inses - incest barrier 
hambatan sosial - social inhibition 
 hasrat berprestasi - achievement motive
 hebefrenia - hebephrenia 
 hedonisme - hedonism 
 hematofobia - hematophobia
 hidrofobia - hydrophobia 
 hipnosis - hypnosis 
 hiperkinesis - hyperkinesis 
 hipofrenia - hypophrenia 
 hipokondria - hypochondria 
 histeria - hysteria 
 homoerotik - homoerotic 
 homoseksualitas - homosexuality 
 hubungan rapport 
 hukuman - punishment 
 hukum Ebbinghaus - Ebbinghaus law 
 hukum keberhasilan; hukum akibat - law of effect
 hukum latihan - law of exercise
 hukum pengurangan - law of diminishing return 
 
 I 
 ide; gagasan - idea 
 ide meloncat - flight of ideas 
 ide fiks - fixed idea 
 
ideal - ideal 
ideal ego - ego ideal 
identifikasi - indetification 
identifikasi orang tua - parental indetification
 identitas pribadi - personal identity 
ideoglosia - ideoglossia 
ideosinkrasi - ideosyncrasy 
idiot - idiot
idiot savant - idiot savant 
iklim sosial - social climate 
ikon - icon 
ilham - illumination 
ilmu kedokteran anak - pediatric 
ilmu pasti - natural science 
ilmu-ilmu sosial - social sciences 
ilmu tingkah laku - - behavioral science 
ilusi - illusion 
imago - imago 
imajinasi - imagination 
imbesil - imbecile 
impersepsi - imperception 
impotensi - impotence 
imprinting - imprinting 
impulsif - impulsive 
imoral - immoral 
individualitas - individuality 
infantilisme - infantilism 
inferioritas jasmani - organ inferiority 
ingatan - memory 
ingatan semu - pseudomemory 
inkoherensi - incoherence 
insting hidup - life instinct 
insting mati - death instinct 
insting sekawan - herd instinct 
inteligensi - intelligence 
inteligensi sosial - social inteligence 
inteligensi umum - general intelligence 
intelek - intellect 
intensionalisme - intentionalism 
interkalasi - intercalation 
introjeksi - introjection 
introversi - introversion 
introver - introvert 
inventori - inventory 
iri - envy 
isap jari - finger sucking 
isomorfisme - isomorphism 
IQ - Intelligence Quotient 

J
janin - fetus
jarak sosial - social distance 
jawaban egosentris - egocentric response 
jenjang kebiasaan - hierarchy of habit 
jouska

K 
kaca diri - self looking glass 
kainofobia - kainophobia 
kambing hitam - scapegoat 
karakter - character 
kastrasi - castration 
kecemasan kastrasi - Castration anxiety
kompleks kastrasi - Castration complex
kata hati - conscience 
kata-kata bermuatan - loaded words 
katarsis - catharsis 
kata tak bermakna - nonsense syllable 
kawin paksa - shotgun marriage 
keagresifan - aggressiveness 
kebancian - hermaphroditism 
kebebasan - freedom 
keberhasilan - achievement 
kebiasaan - habit 
kebisuan - alalia 
vkebisuan mental - mental dumbness 
kebosanan - boredom 
kebosanan - ennui 
kebutuhan - need 
kebutuhan fisiologis - physiological need 
kebutuhan ketergantungan - dependency need 
kebutuhan pasif - passivity need 
kebutuhan rasa terlindung - safety need 
kebutuhan sosial - social need 
kebutuhan status - status need 
kebutuhan untuk tidak dipersalahkan - need for blame avoidance. 
kecakapan akademis - academic aptitude 
kecanduan obat - drug addiction 
kecemasan - anxiety 
kecenderungan - tendency 
kecenderungan pelarian diri - escapism 
kegemukan - obesity 
kegiatan sosial - social activities 
kegilaan erotik - eroterflaflia 
kelelahan - exhaustion 
kehilangan objek - object less 
kekakuan - rigidity 
kekurangan - deficiency 
kelambatan bicara - delayed speech 
kelamin - sex 
kelas sosial - social class 
kelompok bermain - play group 
kelompok informal - informal group 
kelompok primer - primary group 
kelompok teman - peer group 
kelompok sensitivitas - sensitivity group 
keluarga Kallikak - Kallikak family 
keluwesan - motility 
kemajuan - improvement 
kemampuan - ability 
kemampuan belajar - learning ability 
kemampuan didik - educability 
kemampuan indera - sensory ability 
kemampuan mekanis - mechanical ability 
kemampuan motoris - motor ability 
kemampuan umum - general ability 
kematangan seksual - sexual maturation 
kematangan sosial - social maturity 
kematangan - naturiti
kembar identik - identical twins 
kembar tidak identik - freternal twins 
kemunduran motoris; retardasi - motoris 
kemunduran - deteriorasi 
kemunduran mental - mental retardation
kemurungan - dejection 
kepekaan - sensibility 
kepemimpinan - leadership 
kepemimpinan berbagi - shared leadership 
kepercayaan diri - self confidence 
kepribadian - personality 
kepribadian mantap - intregated personality 
kepribadian paranoid - paranoid personality 
kepnibadian terhambat - inhibited personality 
kepribadian terpecah - split personality 
kepribadian skizoid - schizoid personality 
kepnibadian skizofrenia - schizophrenia personaliti
kepribadian sosiopati - sociopathic personality 
kepuasan - satisfaction 
keriangan - euphoria 
k- egembiraan elation 
kerdil - dwarfism 
kerusakan otak - organic brain disease 
kesadaran - awareness 
kesadaran bersama - general consciousness 
kesadaran sosial - social inwardness 
kesalahan bicara - speech errors 
kesan pengamatan - impression 
kesatuan bentuk - gestalt 
keseimbangan - equilibrium 
kesenangan fungsional - functional pleasure 
kesiagaan mental - mental alertnes 
kesiapan - set 
kesiapan sekolah - school readiness 
ketaatan - obedience 
ketahanan - endurance 
- ginofobia gynophobia 
keterbelakangan semu - pseudofeeblemindedness 
ketergantungan - dependency 
ketergantungan obat - drug dependence 
keterbelakangan - backwardness 
ketetapan ukuran - size constancy 
ketidakpekaan - desensitization 
keterampilan - skill 
keterampilan bicara - speech skill 
keterampilan menolong diri sendiri - self help skills 
kecakapan-  aptitude 
keturunan - heredity 
kewaspadaan - alertness 
khayalan - fantasy 
kidal - lefthandedness 
kinesis - kinesis 
kinestesis - kinaesthesis 
klasifikasi sosio ekonomik socio economic classification 
klaustrofobia - claustrophobia 
kleptomania - kleptomania 
kolerik - choleric 
kompensasi - compensation 
kompensasi berlebihan - overcompensation
kompetensi sosial - social competency 
kompleks - complex 
kompleks keibuan - mother complex 
kompleks Oedipus - Oedipus complex 
kompulsi - compulsion 
kondisioning instrumental - instrumental conditioning 
kondisioning kembali - reconditioning 
kondisioning operan - operant conditioning 
konfabulasi - confribulation 
konflik - conflict 
konflik dalam - intrapsychic conflict 
konflik dorongan - motivational conflict 
konseling - counseling 
konsep aku - I concept 
konsep diri - self concept 
konsep ruang - space concept 
konsep waktu - time concept 
konstipasi - constipation 
kontak sosial - social contact 
koordinasi senso motoris - sense motoric coordination 
kotak skinner - skinner box 
kretinisme; kontet - cretinism 
kurva normal - norma curve 
kurva belajar - learning curve 
kurang perhatian - in-attention 
kuebiko

L
liberosis
lachesism
laku sosial - social play 
lambat-belajar - slow learner 
lari - flight 
latah
latihan - training  
latihan formal - formal exercises 
latihan kebersihan - cleanliness training 
latihan sensitivitas - sensitivity training 
latihan silang - cross education 
latihan spontanitas - spontaneity training 
lemah mental - idiocy 
lemah pikiran - feeblemindedness 
lenyap - leading 
leptosom - leptosome 
lesbian - lesbian 
vlibido organ - organ libido 
lingkungan - environment
lingkungan hidup - life space 
lingkungan sosial - social environment 
lonjakan - spurt 
logat - slang 
logorea - logorrhea 
loyo; astenia - asthenia 
luar kelompok - outgroup 
limerence

M
mania diri - selfishness manik depresif - manic depressive 
manusia eidetik eidetiker; - eidetic individual 
masa menentang - age of defiance. 
masa remaja; adolesensi - adolescence 
masak; matang - mature 
masa laten latency - period 
masa pancaroba - storm and stress
masa peka - sensitivity period 
masa pre-oedipal - Pre-oedipal phase 
masa puber - puberty 
masokisme - masochism 
masturbasi; onani - masturbasi 
megalomania - megalomania 
mekanisme pertahanan - defense mechanism 
mekanisme penyesuaian - mechanism ofadiustinent 
melamun - daydreaning 
memainkan peran - role playing 
membaca bibir - lip reading 
menarik diri - abience 
mengamati sepenuhnya; apersepsi - apperception 
mengambang - abulia 
mengenal kembali - recognation 
mengigau - delirium 
mengingat - memorizing 
mengingat kembali - recall 
mengoceh - lalling 
menjelma - impersonation 
mental - mental 
menyalurkan - acting out 
meracau - babbling stage 
mesin pengajar - teaching machine 
metapsikologi - metapsychology 
metode heuristik - heuristic method 
metode idiografi - idiographic method 
metode impresi - impression method 
metode kelompok  latihan - training group method 
metode menjawab bebas - free response method 
metode Montessori - Montessori method 
metode proyeksi - projection method 
mimpi buruk - nightmare 
minat - interest 
minat pribadi - self interest 
minat sosial - social interest 
mobilitas sosial - social mobility 
mongolisme - mongolism 
moral - morale 
moral dilemmas
moron - moron 
motif berfungsi otonom - functional autonomy 
motif dasar - basic motives 
motif intrinsik - intrinsic motive 
motivasi - motivation 

N
nafsu - lust 
nalar - reason
naluri - instinct 
narsisme - narcissism 
nativisme - nativism 
negativisme - negativism 
neologisme - neologism 
neurastenia - neurasthenia 
neurosis - neurosis 
ngompol - enuresis 
nilai bertahan hidup - survival value 
nilai moral - moral value 
nilai sosial - social value 
norma - norm 
norma tes - test norm 
norma umum - general norms 
nosofilia - nosofile
nodus tollens

O
opia
object anti cathexis - objek anti kateksis
objek-libido - object libido 
obsesif kompulsif - obsessive compulsive 
occhiollism
Oedipus 	kompleks 
oligofrenia - oligophrenia 
onism
ontogenesis - ontogenesis 
optimistik - optimistic 
orang gila - lunatic 
organisme - organism 

P 
peka rangsang - excitability 
pelibatan diri - ego involvement 
pengamatan sosial; wawasan sosial - sosial insight 
pengelompokan x y z - x y z grouping 
penguat - reinforcement 
penyesuaian nyata - reality adaptation 
perubahan pendidikan; pembaharuan pendidikan - educational reform 
prejudice 
psikologi - psychology
psikosis endogen - endogenous psychosis 

S 
sifat menerima - receptive character 
studi gerak dan waktu - time and motion study 

T 
tabula rasa - tabula rasa 
tafsir mimpi - interpretation of dreams
tahap coba-coba - testing stage 
tahap oral - oral phase 
takut - fear 
taraf kematangan - maturity level 
taraf prestasi - level of performance 
tegangan; ketegangan - tension 
tekanan - stress 
teknik buta sebelah - single blind technique 
teknik pilih - sorting technique 
teknik simulasi - simulation technique 
temperamen sanguin - sanguine temperament 
teori dorongan tunggal - monomotive theory 
Teori 
teori imitasi dalam bahasa - imitation theory language 
teori James Lange - James-Lange theory 
teori konvergensi - convergence theory
teori praktis - practice theory
terapi aktif - active therapy
terapi bayangan mental - mental imagery therapy 
terapi bermain - play therapy 
terapi bicara - speech therapy 
terapi kejut - shock therapy 
terapi kelompok - group therapy 
terapi kerja - occupational therapy 
terapi musik - music therapy 
terapi pelegaan - release therapy 
terapi tak langsung - nondirective therapy 
terapi tunjang hela - supportive therapy 
terbuka - overt 
terhambat; bloking - blocking 
teror; ketakutan - fright 
tes batas waktu 
tes bebas budaya - cultural free test 
tes berbisik - whispered test 
tes hasil kerja; tes prestasi - achievement test 
tes htp': '- House Tree Person test
tes individual - individual test 
tes inteligensi - intelligence test 
tes introversi ekstraversi - introversion extraversion test 
tes kecepatan - speed test 
tes kecepatan tangan - dexterity test 
tes kelompok - group test 
tes kemampuan khusus - special abilities test 
tes bakat khusus - special aptitude test 
tes kepribadian - personality test 
tes mental - mental test 
tes obyektif - objective test 
tes pengetahuan - information test 
tes pilihan berganda; tes pilihan ganda multiple choice test 
tes psikomotor - psychomotor test 
tes situasional - situational test 
tes tingkatan - attitude test 
testing kenyataan - reality testing 
tidak adanya kasih ibu - maternal bereavement 
tidak ingat - amnesia 
tidur-berjalan - sleepwalking 
tiga dasar kebahagiaan - three foundations of happiness
tingkah laku - behavior 
tingkah laku antisosial - antisocial behavior
tingkah laku bawaan - native behavior
tingkah laku dalam - implicit behavior
tingkah laku instrumental - instrumental behavior
tingkah laku latah - echopraxia
tingkah laku luar - overt behavior
tingkah laku terbuka
tingkah laku naluriah - instinctive behavior
tingkah laku normatif': '- normative behavior
tingkah laku operan - operant behavior
tingkah laku prasosial - presocial behavior
tingkah laku rasional - rational behavior
tingkah laku sosial': '- social behavior
tingkat - grade
tipe belajar - learning type 
tipe ekonomi - economic type
tipe histeria - hysterical type
tipe intuitif - intuitive type
tipe konstitusional - constitutional type
tipe perasa - feeling type
tipe reaktif - reactive type
toleransi frustrasi - frustration tolerance
tomboi - tomboy
trait; sifat - trait 
trance - trance 
transferensi - transference 
transfer negatif - negative transfer 
transfer positif - positive transfer 
transvetisme - transvetism 
trauma kelahiran - birth trauma 
tujuan - goal 
tuli bisu - deaf mute
tuna aksara - alexia

U 
umpan balik feedback - feedback
urutan kelahiran - birth order
usia - age
usia kronologi  - chronological age 
usia mental - mental age 
usia keberhasilan - achievement age
usia lanjut - senescense
usia malu - shy age
usia perkembangan - developmental age

V 
valensi - valence
validitas - validity
variabel bebas - independent variable
vertigo - vertigo

W 
waktu laten - latent time
waras - sane
warisan sosial ;bawaan sosial - social heritage
wawancara - interview
wawasan sosial - social insight

x 
xenofobia - xenophobia
xenoglosi - xenoglossy
xenoglosofobia - xenoglosso phobia 

Y 
yatim piatu - orphan

Z 
zoofobia - zoophohia
zoofilia - zoophiia

********************
sumber data:
1. https://repositori.kemdikbud.go.id/2921/1/kamus%20istilah%20psikologi%20%20-%20%2092ha.pdf
2. https://profesi-unm.com/2020/12/12/kenali-15-istilah-psikologi-untuk-perasaan-yang-sulit-dijelaskan/